11111111111111111111
111111111E1111111111
10000100000000100001
10C0000000000000C001
10000100000000100001
11111111100111111111
10000000100000000001
10000000100000000001
10000000100000000001
10C00000100000000001
10C00000100000000001
10000000111111011111
10000000000000000001
10011111111111101111
100100C010000000C001
10010000100C00000001
10011011111111111111
10011011111111111111
100000000000000000P1
11111111111111111111
