11111
10001
10101
1E101
1P0C1
11111
